11111111111111111
10001000100010001
10000000000000001
10000000000000001
10000000100000001
11000001110000011
10000011111000001
10000001110000001
10000011111000001
11000001110000011
10000000100000001
10000000000000001
10000000000000001
10001000100010001
11111111111111111
