111111111111111111111111
111111111000000111111111
111111110000000011111111
111111100000000001111111
111111000110011000111111
111110001100001100011111
111100011000000110001111
111000110000000011000111
110001100000100001100011
100001100001110001100001
110001100000100001100011
111000110000000011000111
111100011100001110001111
111110000110011000011111
111111000010010000111111
111111100000000001111111
111111110000000011111111
111111111000000111111111
111111111111111111111111
